NO ./assets/PT_BLACK.xpm
SO ./assets/PT_COAL.xpm
WE ./assets/PT_DIRT.xpm
EA ./assets/PT_BEIGE.xpm

F 160,160,160
C 32,32,32

   111111111111111111111111111111111111111111111111111
   100000000000000000000000000000000000000110000000001
   100000000000000000011110000000000000000000000000001
   1000111111110000000100010000000000S0000000000000001
   10001     10000000010000100000000000000110000000001
   10001     10001111111111111111111100000110000000001
111100011111111100000000000000000000000011110000000001
100000000000000000000000000000000000000011100000000001
100000000000000000011111000000000000000011100000000001
100001111111000000010001000001000000000011100000000001
100001111111000000010001111111100011111111100000000001
100000000001000000011110000000000000000000000000000001
100000000001000000000000000000000000000000000000000001
111000001111111111111111111111111111111111100000000001
  1000001                                 100000000001 
  1111111                                 100000000001
                                          100000000001
                                          111111111111