NO ./assets/bark.xpm
SO ./assets/backroom.xpm
WE ./assets/bricks.xpm
EA ./assets/gravel.xpm

F 225,30,0

11111111111111111111111111111111
10000000000000000000000000000001
10000000000000000000000000N00001
10000000000000000000000000000001
10000000000000S00000000000000001
10000000000000000000000000000001
10000000000000000000000000000001
11111111111111111111111111111111
