NO ./assets/PT_BLACK.xpm
SO ./assets/PT_COAL.xpm
WE ./assets/PT_DIRT.xpm
EA ./assets/PT_BEIGE.xpm

F 160,160,160
C 32,32,32

        1111111111111111111111111
        1000000000010000000000001
        10110000010100000000100S1
        100100000000000000001001
111111111011000001010000000000001
100000000011000001010111111111111
11110111111111011100000010001
11110111111111011101010100001
11000000110101011100000010001
10000000000000000000N00010001
10000000000000001101010010001
1100000111010101111101111000111
11110111 1110101 101111010001
11111111 1111111 111111111111
